11111111111111
1P010000000001
10010000000001
10010000000001
10010001000001
10010001000001
10010001000001
10010001000001
10010001000001
10000001000001
10000001000001
10000001000E01
11111111111111
