1111111111111111111111111111
1000000000000000000000000001
1001110001111000111101111001
1001C100000C100000C1000C1001
1001010000111000011100001001
10000100000C100000C100001001
1000111001111000111100001001
10P000000000000E000000000001
1111111111111111111111111111
