1111111111111111111111111111
1000000000000000000000000011
10011100011110P0011110111101
1001C100000C100000C1000C1001
1001110000111000011100001001
10000100000C100000C100001001
1000111001111000111100001001
1000000000000000000000000011
1111111111111111111111111111
