111111111111
100P0C0E0001
111111111111
