1111111111
100P00C0E1
1111111111
