


111111
100101
1E0CP1
111111
