1111111111
100C0PE111
1111111111
